--------
-1-11-1-
-111111-
-342243-
-213312-
-135531-
--1331--
--------
