--------
-112243-
-324243-
-134343-
-344442-
-155321-
-155453-
--33143-
--------
