-----------
-111334221-
-13-2341---
-33353--33-
-1-3343343-
----144421-
-----------
